##############################################################################
#				       				             #
#				       				             #
#				       				             #
#		   ######						     #
#		     ########						     #
#		       #######################################################
###########            ##########					     #
###########            ##########					     #
###########			       ############## 			     #
###########			       ###############			     #
###################################################################          #
#						       ############	     #
#									     #
#									     #
#									     #
#        ######################################				     #
#					   ###################################
#								##############
#								    ##########
#									######
###################################					     #
#			       ##############~~~~~~~~~~##########	     #
#				 #################################           #
#					     			  	     #
#########################						     #
#									######
#								      ########
#								      ########
###################################~~~~~~~~~~######~~~~~~~~~~#################
##############################################################################
