###############################################################################
#                                                                             #
#                                                                             #
#                                                                             #
#                   ######                                                    #
#                     ########                                                #
#                       #######################################################
###########            ##########                                             #
###########            ##########                                             #
###########                               ##############                      #
###########                               ###############                     #
##################################################################            #
#                                                       ###########           #
#                                                                             #
#                                                                             #
#                                                                             #
#        ######################################                               #
#                                           ###################################
#                                                                ##############
#                                                                    ##########
#                                                                        ######
###################################                                           #
#                               ##############~~~~~~~~~~##########            #
#                                 #################################           #
#                                                                             #
#########################                                                     #
#                                                                        ######
#                                                                      ########
#                                                                      ########
###################################~~~~~~~~~~######~~~~~~~~~~##################
###############################################################################
